..##..
.....######
.##...#...#
##..#.#...#
##..@.....#
#....###..#
#....#....#
.##.##...##
.#..#...##
.#..#..##
.#######