...###
...#.#.####
.#...##...#
.##.....#.#
....@#.##.#
########..#
.....#....#
.#..##.#.##
.#..#......
.#..#..##..
...##......